####################
#0000##########0000#
#0000##########0000#
###00#00000000#00###
#0000#---00---#0000#
#0000#000XX000#0000#
#00--#00-##-00#--00#
#0000##000000##0000#
#---0###0000###0---#
#000000##00##000000#
###00000000000000###
#0000@00-##-00b0000#
#000###000000###000#
#00#####0000#####00#
####################