11111111111111111111
10000111111111100001
10000111111111100001
11100100000000100111
10000100000000100001
10000100000000100001
10000100111100100001
10000110000001100001
11100111000011100111
10000001100110000001
11100000000000000111
10000@00011000000001
10001110000001110001
10011111000011111001
11111111111111111111