11111111111111111111
11100000000000000111
111#0000000000000111
111110000110000@0111
11100000000001111111
11100000000011111111
11111111000000000111
1110000000111111#111
11100#00000000111111
11111110011100000111
11101#00000000000111
11101111111111100111
11100000000000000111
1110#0001XX00000111
11111111111111111111