11111111111111111111
10000111111111100001
1#0001111111111000#1
11100100000000100111
100001---00---100001
100001000XX000100001
100--100-11-001--001
10000110000001100001
1---011100001110---1
10000001100110000001
11100000000000000111
10000@00-11-00000001
10001110000001110001
10011111000011111001
11111111111111111111